    
          
  R  1980 1024

WE ./textures/red.xpm
NO ./textures/green.xpm
SO ./textures/blue.xpm
EA ./textures/yellow.xpm



S  ./textures/Gold0.xpm





F     220,   100,   244


C                      92,                    241,             246
          
				




111111111
1S0202001
100000001
100000001
1002020211111
1000000000001
1000000000001
1011111100001
101    100001
111    100001
       100001
       100001
       100001
       111111




