    
          
  R  800 600

WE ./textures/red.xpm
NO ./textures/green.xpm
SO ./textures/blue.xpm
EA ./textures/yellow.xpm



S  ./textures/Gold0.xpm





F    101, 28, 120


C                      48, 179, 194
          
				




111111111
100000001
100000001
100000001
1000S00011111
1000000000001
1000000000001
1011111100001
101    100001
111    100001
       100001
       100001
       100001
       111111




