    
  R      50     1980

 
NO                             ./path_to_the_north_texture
SO ./path_to_the_south_texture
WE ./path_to_the_west_texture
EA ./path_to_the_east_texture
S ./path_to_the_sprite_texture


F 220,   100,   244

EA ./path_to_the_east_texture

C                           249,                                           225,             10

111111111
100202001
100000001
100N00001
100202021
100000001
100000001

 