
          
  R  800 600

WE ./textures/colorstone.xpm
NO ./textures/wood.xpm
SO ./textures/greystone.xpm
EA ./textures/mossy.xpm



S  ./textures/barrel.xpm




F    101, 28, 120


C                      48, 179, 194
          




        1111111111111111111111111
        1000000000110000000000001
        1011000001110000002000001
        1001000000000000000000001
111111111011000001110000000000001
100000000011000001110111111111111
11110111111111011100000000001
11110111111111011101010010201
11000000110101011100000010001
20002000000000001100000010201
20000000000000001101010010001
21000001110101011111011110N0112
11110111 1110101 101111010001
11111111 1111111 111111111111

