    
          
  R  800 600

WE ./textures/red.xpm
NO ./textures/green.xpm
SO ./textures/blue.xpm
EA ./textures/yellow.xpm



S  ./textures/barrel.xpm





F    101, 28, 120


C                      48, 179, 194
          





111111111
122222221
122222221
122222221
1222W02211111
1222222222221
1222222222221
1211111122221
121    122221
111    122221
       122221
       122221
       122221
       111111