R 800 600
        WE textures/edgar.xpm
        NO     ./textures/wood.xpm
SO ./textures/greystone.xpm
        EA ./textures/dog.xpm
                S ./textures/cheese.png
        F 0,0,0
                C 255,255,255

        111111111111111111111111111111111111111111111111111111111111111111
        111120202000022222220000000000000000000000000000000021111111111111
        111100000000000000000000000000000000000000000000000001111111111111
        111100000001111111111111111122221111111111111110000001111111111111
        1111100N0000000022222000000211111111111111111111000000111111111111
        11100000001200000000000000001   1111111111111111000001111111111111
        11111000001111000000000111111   1111111111111112000002111111111111
        11100000000000000000000000001   1111111111111112000002111111111111
        11100001111000110101010101001   1110000000000002000002000000022111
        11100000000010000000000000001   11110000000000020000020000000002111111111111111111     
        11100000000010000002000000001   11110000000000020020020000000002000000000011111111
        11111111111111111111111111111   11100000000000020000020000000000000000000000000011
                                        11100000000000020000000000000001111110000110000011 
                                        11100000000000020000000000000201111110000110000011
                                        11111111111111110000011111111111111110000110000011
                                                11111111000001111111       110000110000011
                                                11111111000001111111       110000000000011
                                                11111111100011111111       110000000000011
                                                11111111100011111111       111111111111111
                                                11111111100011111111
                                                11100000000000002111
                                                11120000000000000111
                                                11111111111111111111