    
          
  R  800 600

WE ./textures/red.xpm
NO ./textures/green.xpm
SO ./textures/blue.xpm
EA ./textures/yellow.xpm



S  ./textures/barrel.xpm





F    101, 28, 120


C                      48, 179, 194  

        11111111111111111111111122222
        1000000000110000000111211
        1011000001110000020110001 2
        102100000E000000000110001
111111111011000001110000000000001
100000000011000001110111111111111
11110111111111011100000010001
11110111111111011101010010001
11000000110101011100000012001
10022200000000001100000000001
10020200000000001101010010001
112002011101010111110111100111
11110111 1110101 101111010001
11111111 1111111 111111111111