
    
          
  					 R  1200 800


		WE       textures/edgar.xpm
	NO   ./textures/wood.xpm
 SO textures/colorstone.xpm
EA ./textures/dog.xpm



        S ./textures/sprite_cat_in_box.png

	F 		100, 	 100, 100


C                     255 ,   255    ,             220


        1111111111111111111111111
        1000000000110000000001011
        1011000001110000002000001
        1001000000000000000002001
111111111011000001110000000000001
100000000011000001110111111111111
11110111111111011100000010001
11110111111111011101010010201
11000000110101011100000010001
10002000000000001100000010201
10000000000000001101010010001
11000001110101011111011110N0111
11110111 1110101 101111010001
11111111 1111111 111111111111