	
R      1200 801

WE textures/edgar.xpm
NO      ./textures/wood.xpm
SO ./textures/greystone.xpm
EA ./textures/dog.xpm



S       ./textures/sprite_tennis_ball.xpm
S       ./textures/barrel.xpm
S      ./textures/sprite_cat_in_box.xpm



F          ./textures/mossy.png
C         textures/wood.xpm





        1111111111111111111111111
        1000000000110023043202001
        1011000001110000000000401
        1001000000000003002000201
111111111011000001110004000000301
100000000011000001110000000011111
11110111111111011100000000001
11110111111111011101010010301
11000000110101011100000010001
10002000000000001100000010201
10000000000000001101010010001
11000001110101011111011110N0111
11110111 1110101 101111010001
11111111 1111111 111111111111