    
          
  R  8000000000000000000000 600

WE ./textures/red.xpm
NO ./textures/green.xpm
SO ./textures/blue.xpm
EA ./textures/yellow.xpm



S  ./textures/barrel.xpm





F    101, 28, 120


C                      48, 179, 194
          





11111111111111111111111111111
10000000001100000000000000001
10110000011100000000000010001
101000000000000000000W0100001
10110000011100000000000010001
10000000001100000111011110001
11110111111111011100000010001
11110111111111011101010000001
11000011111111111000000000001
1000001       100000000000001
10000011111111101101010010001
11000000110101011111011110001
11110111111101011111011110001
11111111111111111111111111111




